NO ./texture/bluestone.xpm
SO ./texture/eagle.xpm
WE      ./texture/purplestone.xpm
EA ./texture/redbrick.xpm   

F 0, 0,    0   
C 255,255,255

111111111111
1111000011   1111
1000000111  1N01
100000011 1  111
11111111111






