NO ./texture/bluestone.xpm
SO ./texture/eagle.xpm
WE       ./texture/purplestone.xpm
EA ./texture/redbrick.xpm   
FI ./texture/stone.xpm

US ./texture/nyan_cat.xpm


DO ./texture/door
DB ./texture/dancing_bear
DD ./texture/dancing_dog
DC ./texture/dancing_cat
PS ./texture/pepsi

F 0,0,0
C 255,255,255

111111111111111
100000000010001
100000000010001
100000011000001
100000010000001
100000010000001
101111110000001
100010000010001
100010000010001
100011111110001
10N000000000001
111111111111111
