NO ./texture/bluestone.xpm
SO ./texture/eagle.xpm
WE       ./texture/purplestone.xpm
EA ./texture/redbrick.xpm   
FI ./texture/stone.xpm

US ./texture/nyan_cat.xpm

DO ./texture/door
DB ./texture/dancing_bear
DC ./texture/dancing_cat
DD ./texture/dancing_dog
PS ./texture/pepsi

C 255,255,255
F 0,0,0

111111111111111
100000000000001
100000000000001
100000000000001
100000000000001
100011111110001
100010000010001
1000V00N0010001
100011111110001
100000000000001
10000000C000001
100000000000001
111111111111111
