NO ./texture/bluestone.xpm
SO ./texture/eagle.xpm
WE       ./texture/purplestone.xpm
EA ./texture/redbrick.xpm   
FI ./texture/stone.xpm

US ./texture/nyan_cat.xpm

DO ./texture/door
DB ./texture/dancing_bear
DC ./texture/dancing_cat
DD ./texture/dancing_dog
PS ./texture/pepsi

C 255,255,255
F 0,0,0

111111111111111
10110000001000111111111
11C1000001000100000011
10110011111000000111111
10000001000000100001
10001H1111100111111
10011010V00001
100011001010001  111
100010000010001  101
100011111110001  111
10E00000B000001
111111111111111
