NO ./texture/bluestone.xpm
SO ./texture/eagle.xpm
WE       ./texture/purplestone.xpm
EA ./texture/redbrick.xpm   
FI ./texture/stone.xpm

DO ./texture/barrel.xpm 8
ZO ./texture/btninet.xpm 8
ME ./texture/greenlight.xpm 8 
GU ./texture/nazi.xpm 12

F 0,0,0
C 255,255,255

11111111111
100D0001111
10010000001
1100S101111
11111111111
