F 0,         000,  255
C 0,255,0


NO ./texture/bluestone.xpm
SO ./texture/eagle.xpm
WE      ./texture/purplestone.xpm
EA ./texture/redbrick.xpm   


11111111111111111111
10000001N10000000011
1000000110    00000011
10000000000000000011
11111111111111111111
