F 0, 0,  255
C 0,0,0


NO ./texture/bluestone.xpm
SO ./texture/eagle.xpm
WE      ./texture/purplestone.xpm
EA ./texture/redbrick.xpm   


111111111111 11111111111
100000000001 100000000001
100000000001 100000000001
100000000001 100000000001
100000000001 100000000001
111111111111  11111111111
100000000001 100000000001
100000000001 100000000001
100000000001 100000000001
111111111111 11111111111
111111111111 11111111111
1000000E0001 100000000001
100000000001 100000000001
100000000001 100000000001
100000000001 100000000001
111111111111 11111111111





