NO ./texture/bluestone.xpm
SO ./texture/eagle.xpm
WE       ./texture/purplestone.xpm
EA ./texture/redbrick.xpm   
FI ./texture/stone.xpm

ZO ./texture/zombie
DO ./texture/door

F 0,0,0
C 255,255,255

11111111111
100D0001111
10010000001
1100N101111
11111111111
