NO ./texture/bluestone.xpm
SO ./texture/eagle.xpm
WE       ./texture/purplestone.xpm
EA ./texture/redbrick.xpm   
FI ./texture/stone.xpm

F 0,0,0
C 255,255,255

11  111111111
1N111000011
10000001101
11111111111
