NO ./texture/bluestone.xpm
SO ./texture/eagle.xpm
WE      ./texture/purplestone.xpm
EA ./texture/redbrick.xpm   

F 0, 0,  30
C 0, 0 , 255



111111111111 111111111111
100000000001 100000000001      
100000000001 100000000001 
100000000001 100000000001 
100000000001 100000000001 
100000000001 100000000001 
100000000001 100000000001 
100000000001 10000000001 
1000000N0001 100000000001 
100000000001 100000000001 
100000000001 100000000001 
100000000001 100000000001
111111111111 111111111111






