NO ./texture/bluestone.xpm
SO ./texture/eagle.xpm
WE       ./texture/purplestone.xpm
EA ./texture/redbrick.xpm   
FI ./texture/stone.xpm

US ./texture/nyan_cat.xpm

DO ./texture/door
DB ./texture/dancing_bear
DD ./texture/dancing_dog
DC ./texture/dancing_cat
PS ./texture/pepsi

C 0,0,0
F 255,255,255

111111111111111
100000000010001
1000D0000010001
100000011000001
100000010 C0001
100000010 00001
101111110 00001
100010000 10001
10001     10001
1   11111110001
1 N 0000B000001
111111111111111
