NO ./texture/bluestone.xpm
SO ./texture/eagle.xpm
WE       ./texture/purplestone.xpm
EA ./texture/redbrick.xpm   
FI ./texture/stone.xpm

US ./texture/nyan_cat.xpm

ZO ./texture/zombie
DO ./texture/door

F 0,0,0
C 255,255,255

11111111111
10000000001
10000000001
1000N000001
11H10000001
10000000001
11111111111
