F 0, 0,  30
C 0, 0 , 255


NO ./texture/bluestone.xpm
SO ./texture/eagle.xpm
WE      ./texture/purplestone.xpm
EA ./texture/redbrick.xpm   


111111111111 11111111111
100000000001 100000000001
100000000001 100000000001
100000000001 100000000001
100000000001 100000000001
100000000001 100000000001
100000000001 100000000001
100000000001 10000000001
111111111111 1111111111
111111111111 11111111111
1000000N0001 100000000001
100000000001 100000000001
100000000001 100000000001
100000000001 100000000001
111111111111 11111111111





