NO ./texture/bluestone.xpm
SO ./texture/eagle.xpm
WE       ./texture/purplestone.xpm
EA ./texture/redbrick.xpm   
FI ./texture/stone.xpm

US ./texture/nyan_cat.xpm

DO ./texture/door
DB ./texture/dancing_bear
DC ./texture/dancing_cat
DD ./texture/dancing_dog
PS ./texture/pepsi

C 255,255,255
F 0,0,0

111111111111111
100000000000001
10000CDB  00001
100000000000001
100000000000001
100000000000001
1111111H1111111
100000000000001
1000101H1000001
1000V  00000001
10001 1H1000001
10000000000001
100000000000001
100000000000001
1000000W0000001
111111111111111













