NO ./texture/bluestone.xpm
SO ./texture/eagle.xpm
WE       ./texture/purplestone.xpm
EA ./texture/redbrick.xpm   
FI ./texture/stone.xpm

US ./texture/nyan_cat.xpm

DO ./texture/door
DB ./texture/dancing_bear
DC ./texture/dancing_cat
DD ./texture/dancing_dog
PS ./texture/pepsi

C 255,255,255
F 0,0,0

111111111111111
100000000000001
100000000000001
10000CCCCC0C001
100000000000001
100000000000001
100000000000001
1000000000N0001
100000000000001
100000000000001
100000000000001
1000CCC0C0C0001
100000000000001
111111111111111
