NO ./texture/bluestone.xpm
SO ./texture/eagle.xpm
WE       ./texture/purplestone.xpm
EA ./texture/redbrick.xpm   
FI ./texture/stone.xpm

US ./texture/nyan_cat.xpm

DO ./texture/door
DB ./texture/dancing_bear
DC ./texture/dancing_cat
DD ./texture/dancing_dog
PS ./texture/pepsi

C 255,255,255
F 0,0,0

111111111111111
1SV0V0V0V0V0VC1
1H1H1H1H1H1H1H1
10V0V0V0V0V0V01
1H1H1H1H1H1H1H1
10V0V0V0V0V0V01
111111111111111













