NO ./texture/bluestone.xpm
SO ./texture/eagle.xpm
WE       ./texture/purplestone.xpm
EA ./texture/redbrick.xpm   
FI ./texture/stone.xpm

F 0,0,0
C 250,250,250






111111111111111111111
100000000000000000001
100000000000000000001
100000000000000000001
100000000001000000001
100000000000000000001
10000000000N000000001
100000000000000000001
100000000000000000001
100000000000000000001
100000000000000001001
100000000000000000101
100000000000000000001
100000000000000000001
100000000000000000001
100000000000000000001
100000000000000000001
100000000000000000001
100000000001000000001
100000000000000000001
111111111111111111111










