NO ./texture/bluestone.xpm
SO ./texture/eagle.xpm
WE       ./texture/purplestone.xpm
EA ./texture/redbrick.xpm   
FI ./texture/stone.xpm

US ./texture/nyan_cat.xpm

DO ./texture/door
DB ./texture/dancing_bear
DC ./texture/dancing_cat
DD ./texture/dancing_dog
PS ./texture/pepsi

C 255,255,255
F 0,0,0

111111111111111
1000C00000D0001
100000000000001
100000000000001
1000000000B0001
100000N00000001
111111111111111













